
==== DEFINICIONES ====

Hijo/hija = this.child (Uno de ellos) --Incluído en la clase Person
padre/madre = this.mother / this.father --Incluído en la clase Person

el sobrino	el hijo de mi hermano/a
la sobrina	la hija de mi hermano/a

el abuelo	el padre de mi padre/madre
la abuela	la madre de mi padre/madre

el padrastro	el esposo de mi madre que no es mi padre
la madrastra	la esposa de mi padre que no es mi madre

el hermanastro	el hijo de mi padrastro/madrastra y no de mi padre o madre
la hermanastra	la hija mi padrastro/madrastra y no de mi padre o madre

la prima	la hija de mi tío/a
el primo	el hijo de mi tío/a

el hermano	el hijo de mis dos padres
la hermana	la hija de mis dos padres

la tía	la hermana de mi madre o padre
el tío	el hermano de mi madre o padre

el bisabuelo	el papá de mi abuelo/abuela
la bisabuela	la mamá de mi abuelo/abuela

la cuñada	la esposa de mi hermano
el cuñado	el esposo de mi hermana

el nieto	el hijo del hijo o hija de mi abuelo/a ??
la nieta	la hija del hijo o hija de mi abuelo/a ??

casarse	unión legal de dos personas ??



No se si añadir:

(el medio hermano	el hijo sólo de mi padre o madre
la media hermana	la hija sólo de mi padre o madre
el/la vecino/a	la persona que vive muy cerca de mi casa
la novia	la mujer con quien tengo una relación romántica
el novio	el hombre con quien tengo una relación romántica)